01000100010001000100
01010101010101010100
01010101010101010100
01010101010101010100
01010101010101010100
01010101010101010100
01010101010101010100
01010101010101010100
01010101010101010100
01010101010101010100
01010101010101010100
01010101010101010100
00010001000100010000
